11111111111
10000000001
1000E000001
10000000001
10000000001
1000C000001
10000000001
1000P000001
10000000001
10000000001
10000000111
10000011111
11111111111
