111111111111111111111111111111111
100000000000000000000000000000001
100P00000000000000000000000000101
1000000000000000E0000000000000001
100000000000000000000000000000001
100000000C00000000000000000000001
100000000000000000000000000000001
100000000000000000000000000000001
100000000000000000000000000000001
100000000000000000000000000000001
100000000000000000000000000000001
100000000000000000000000000000001
100000000000000000000000000000001
100000000000000000000000000000001
100000000000000000000110000000001
100000000000000000000010000000101
100100000000000000000010000000101
100000000000000000000010000000001
100000000000000000000010000000001
111111111111111111111111111111111