11111111111111111111111111111111111111111111111111111111111111111111111111111111111111111111111111111
10P0100000000000000000000000000000000000000000000000000000000000000000C000000000000000000111111111111
10P010000000000000000000000000000000000000C0000000000000000000000000000000000000000000000000000011111
11111000000000000000000000000000000000000000000000000000000000000000000000000000000000000000000000111
1000000C000000000000000000000000000000000000000000000000000000000000000000000000000000000000000000011
100000000000000000P0000000000000000000000000000000000000000000000000000000000000000000000000000000011
10000000000000000000000000000000000000000000000000000000000000000000000000000000000000000000000000011
10000000000000000000000000000000000000000000000000000000000000000000000000000000000000000000000000001
10000000000000000000000000000000000000000000000000001111111111000000000000000000000000000000000000001
10000000000000000000000000000000000000000000000000000000000000000000000000000000000000000000000000001
10000000000000000000000000000000000000000000000000000000000000000000000000000000000000000000000000001
100000000000000000000000C0000000000000000000000000000000000000000000000000000000000000000000000000001
10000000000000000000000000000000000000000000000000000000000000000000000000000000000000000000000000001
10000000000000000000000000000000000000000000000000000000C00000000000000000000000000000000000000000001
10000000000C00000000000000000000000000000000000000000000000000000000000000000000000000000000000000001
10000000000000000000000000000000000000000000000000000000000000000000000000000000000000000000000000001
1000000000000000000000000000000000000000000000000000000E000000000000000000000000000000000000000000001
10000000000000000000000000000000000000000000000000000000000000000000000000000000000000000000000000001
10000000000000000000000000000000000000000C00000000000000000000000000000000000000000000000000000000001
10000000000000000000000000000000000000000000000000000000000000000000000000000000000000000000000000001
10000000000000000000000000000000C0000000000001111110000000000000000C000000000000000000000000000000001
10000000000000000000000000000000000000000000011111111100000000000000000000000000000000000000000000001
10000000000000000000000000000000000000000000000111111111000000000000000000000000000000C00000000000001
10000000000000000000000000000000000000000000000000000001000000000000000000000000000000000000000000001
10000000000000000000000000000000000000000000000000000001000000000000000000000000000000000000000000001
10000000000000000000000000000000000000000000000000000001000000000000000000000000000000000000000000001
10000000000000000000000000000000000000000000000000000001000000000000000000000000000000000000000000001
10000000000000000000000000000000000000000000000000000000000000000000000000000000000000000000000000001
100000000000000000000000000000000000000000000000000000000000000000000000000000C0000000000000000000001
1000000000000000000000000000000000000000000000000000000000000000000000000000000000P000000000000000001
10000000000000000000000000000000000000000000000000000000000000000000000000000000000000000000000000001
1000000000000000000000000000000000000000C000000000000001000000000000000000000000000000000000000000001
10000000000C00000000000E00000000000000000000000000000001000000000000000000000000000000000000000000001
10000000000000000000000000000000000000000000000000000001000000000000000000000000000000000000000000001
10000000000000000000000000000000000000000000000000000001000000000000000000000000000000000000000000001
11111111111111111111111111111111111111111111111111111111111111111111111111111111111111111111111111111
