1111111111111
1000000000001
1000000E00C01
100000000P001
1000000000001
1111111111111