11111111111111111111111111111111111111111111111111111111111111111111111111111111111111111111111111111
1000100000000000000000000000000000000000000000000000000000000000000000C000000000000000000111111111111
10001000000000000000000000000X000000000000C0000000000000000000000000000000000000000000000000000111111
11111000000000000000000000000000000000000000000000000000000000000000000000000000000000000000000000111
1000000C000000000000000000000000000000000000000000000000000000000000000000000000000000000000000000011
100000000000000000P00000000000000000000000000000000000000000000000X0000000000000000000000000000000011
10000000000000000000000000000000000000000000000000000000000000000000000000000000000000000000000000011
10000000000000000X00000000000000000000000000000000000000000000000000000000000000000X00000000000000001
100000000000000000000000000XXXXXXXXXXXXXXXXXXXXXXXX01111111111000000000000000000000000000000000000001
10000000000000000000000000000000000000000000000000000000000000000000000000000000000000000000000000001
10000000000000000000000000000000000000000000000000000000000000000000000000000000000000000000000000001
100000000000000000000000C0000000000000000000000000000000000000000000000000000000000000000000000000001
10000000000000000000000000000000000000000000000000000000000000000000000000000000000000000000000000001
10000000000000000000000000000000000000000000000000000000C00000000000000000000000000000000000000000001
10000000000C00000000000000000000000E0000000000000000000000000000XXXXXXXXXXXXXXXXXXXXXXXXXX00000000001
10000000000000000000000000000000000000000000000000000000000000000000000000000000000000000000000000001
1000000000000000000000000000000000000000000000000000000000000000000X000000000000000000000000000000001
10000000000000000000000X00000000000000000000000000000000000000000000000000000000000000000000000000001
1000000000000000000000000000000000000000C000000000000000000000000000000000000000000000000000000000001
10000000000000000000000000000000000000000000000000000000000000000000000000000000000000000000000000001
10000000000000000000000000000000C0000000000001111110000000000000000C000000000000000000000000000000001
1000000000000000000000000000000000000000000001111111110000000000000000000000000000000000000000XXXXX01
1000000000000000X000000X00000000000000X00000000111111111000000000000000000000000000000C00000000000001
10000000000000000000000000000000000000000000000000000001000000000000000000000000000000000000000000001
10000000000XXXXXXXXXXXXXXXXXXXXXXXXXX0000000000000000001000000000000000000000000000000000000000000001
10000000000000000000000000000000000000000000000000000001000000000000000000000000000000000000000000001
10000000000000000000000000000000000000000000000000000001000000000000000000000000000000000000000000001
10000000000000000000000000000000000000000000000000000001000000000000000000000000000000000000000000001
10000000000000000000000000000000000000000000000000000000000000000000000000000000000000000000000000001
10000000000000000000000000000X0000000000000000000000000000000000000000000000000C000000000000000000001
10000000000000000000000000000000000000000000000000000000000000X00000000000000000000000000000000000001
10000000000000000000000000000000000000000000000000000000000000000000000000000000000000000000000000001
10000000000000000000000000000000000000X0C000000000000001000000000000000000000000000000000000000000001
10000000000C00000000000000000000000000000000000000000001000000000000000000000000000000000000000000001
10000000000000000000000000000000000000000000000000000001000000000000000000000000000000000000000000001
10000000000000000000000000000000000000000000000000000001000000000000000000000000000000000000000000001
11111111111111111111111111111111111111111111111111111111111111111111111111111111111111111111111111111
