1111111111111
1000000000001
1000000000E01
100P00C000001
1000000000001
1111111111111