11111111
10010001
100E0011
100CCP01
11111111