111111111111111111111111111111111
10CCCCC00000000000000000000000001
100P00000000000000000000000000101
1000000000000000E0000000000000001
1000000000000000000000CCC00000001
100000000C00000000000000000000001
100000000000000000000000000000001
100000000000000000000000000000001
100000000000000000000000000000001
10000000000CCCCCCC000000000000001
100000000000000000000000000000001
100000000000000000000000000000001
100000000000000000000000000000001
10000000000000CCC0000000000000001
10000000C000000000000110000000001
1000000000000000000000100CCC00101
100100000000000000000010000000101
100000000000000000000010000000001
100000000000000000000010000000001
111111111111111111111111111111111
