1111111111111111
1000000000000001
10P0000000000001
10E0000000000C01
1000000000000001
1000000000000001
1111111111111111
