111111111111111111111111111111111111111111
100000000000000000000000000000000000000001
100C00000000000000000000000000000000000001
100000000000000000000000000000000000000001
10000000000000000000000000000000000C000001
100000000000000000000000000000000000000001
100000000000000000000000000000000000000001
100000000000001111000000000000000000000001
100000000000111111100000000000000000000001
100000000000011111000000000000000000000001
100000000000000000000C00000000000000000001
100000000000000000000000000000000000000001
100000000000000000000000000111111000000001
10000000000000000000000111111111111000E001
100000000000000000000000111111111000000001
10000000000000000000P000001111100000000001
100000000000000000000000000000000000000001
100000000000000000000000000000000000000001
100000000000000000000000000000000000000001
100000000000000000000000000000000000000001
100C00000000000000000000000000000000000001
100000001111100000000000000000000000000001
100000011111110000000000000000000000000001
100000001111111000000000000000000000000001
100000000111111000000000000000000000000001
1000000000000000000000000000000000C0000001
100000000000000000000000000000000000000001
100000000000000000000000000000000000000001
10000000C000000000000000000000000000000001
100000000000000000000000000000000000000001
100000000000000000000000000000000000000001
111111111111111111111111111111111111111111
