11111111111111111111111111111111111111111111111111
11111111111111111111111111111111111111111111111111
11111100001111111111111111111111000000011111111111
11110000000011111111111100000000000000000011111111
11100000000000111111100000000000000000000001111111
11100000000000000000000000000000000000000000011111
1100C000000000000000000000000000000000000000001111
11000000100000000000000000000111000000000000000111
1100000111000000000000000001111111100000000C000111
11111111111000000000000000110000011000000000000011
11111110011100000000000011100000001100000000000011
11100000011110000000000110000000001110000000000011
110000C00110111111111110000000P00001100000000C0011
11000000111000001111100000000E00000110000000000011
110000001100C0000000000000000000000110000000000011
11000011110000000000000000000000000100000000000011
1100001111000000000000000000000001110000000C000011
10000111111111100000000000000000011000000000000111
10000111111111111100000000000000000000000000000111
10000111111111111110000000000000000000000000000111
11000111110000001111000000000000000000000000001111
11000111100000000111000000000000000000000000111111
11100011000000000011000000000000000000001111111111
1110000100000C000011000000000000000000000001111111
11100000000000000011000000000000000000000001111111
11110000000000000011000000001111000000000000111111
11111000000000000011000000011111100000000000111111
11111000000000000111000001111111111000000000011111
11111100000000001100000011110000111100000000011111
11111100000000000000000111000000001110000000001111
1111110000000000000000011000C000000110000000001111
11111100000000000000000110000000000111000000000111
11111100000000000000000111000000000011000000000111
11111000000000000000000011111100000011100000000011
11111000000000000000000000111110000001110000000011
11111000000000000000000000001111000001110000000011
11111000000111111100000000000111000001110000000011
11110000001111111110000000000011000001100000000011
11100000001110000111000000000011000001100000000011
11100000011110000011100000C00011000011100000000011
111000000111000C0001100000000011000011000000000011
11000000011110000000111000000111000000000000000011
11000000001110000000011000001110000000000000000011
11100000000011000000001110111100000000000000000011
111000000C00110000000001111000000C0000000000000011
11100000000011000000000000000000000000000000000111
11110000000111100000000000000000000000000000011111
11111000001111100000000000000000000000001111111111
11111111111111111111110000000111111111111111111111
11111111111111111111111111111111111111111111111111
